|----------------------------|
| 0 0   0     0   0    0 0 0 |
| 0 0   0     0   0    0 0 0 |
| 0 0 i-8-1  i-8 i-8+1 0 0 0 |
| 0 0  i-1    i   i+1  0 0 0 |
| 0 0 i+8-1  i+8 i+8+1 0 0 0 |
| 0 0   0     0   0    0 0 0 |
| 0 0   0     0   0    0 0 0 |
| 0 0   0     0   0    0 0 0 |
|----------------------------|
